###############################
#   #   #       #   #   # #   #
#   # ### ### ##### # ### # # #
#       # # #     #     #   # #
##### # ### # # ####### ### ###
#   # #      %#   #   #   # # #
### ####### ### # # ### ### # #
#         # #   #     #   #   #
# # # ### ########### # ### ###
# # #   #   # #   %     # #   #
# ##### ##### # ####### # ### #
#   #       # #     # #       #
# ####### ### #  P  # ##### # #
#   #  %    # # d   # # #   # #
# ### # # ### ####### # ### # #
# # # # # # #     #   # # # # #
### # ##### ##### # ### # ### #
# # #   # #     # %           #
# # # # # # # # # # # ##### # #
#   # #     # #   # # #     # #
### ##### ### ####### ### #####
#   #     #   #   #     # #   #
# # # # ######### # ######### #
# #   # #     # #   # %   #   #
##### ###     # # # # ####### #
#     # #     # # # #     #   #
####### ###   # # # ### ### ###
#     #   #   #   #           #
#     ### # ####### ######### #
#                     #  %
#############################
